NO ./sprites/dark-blue-bricks.xpm
SO ./sprites/gray-bricks.xpm
WE ./sprites/light-blue-bricks.xpm
EA ./sprites/orange-bricks.xpm

F 88,0,8
C 255,0,230

1111111111111111111111111
1000000000000000000000001
1011100000000000000111101
10111000000W0000000111101
1011100000000000000111101
1000000000100000100000001
1000000001110001110000001
1000000011111011110000001
1000000011111111110000001
1000000001111111100000001
1000000000111111000000001
1000000000011110000000001
1000000000001100000000001
1000000000000100000000001
1101010101010101010101001
1101010111101101111011101
1000000000000000000000001
1000000000000000000000001
1000000000000000000000001
1000000001111110000000001
1000000001111110000000001
1000000001111110000000001
1000000001111110000000001
1000000001111110000000001
1000000000111100000000001
1000000000000000000000001
1111111111111111111111111
