NO ./sprites/dark-blue-bricks.xpm
SO ./sprites/gray-bricks.xpm
WE ./sprites/light-blue-bricks.xpm
EA ./sprites/orange-bricks.xpm

F 0,154,23
C 173,216,230

111111111111
1000S0000001
100101010001
100101000001
100101011111
100001011001
101111111101
101111111001
100000000011
100000000001
100101011011
111111111111
