NO ./sprites/dark-blue-bricks.xpm
SO ./sprites/gray-bricks.xpm
WE ./sprites/light-blue-bricks.xpm
EA ./sprites/orange-bricks.xpm

F 220,108,55
C 100,255,12

11111
10001
10101
100N1
11111