NO ./sprites/dark-blue-bricks.xpm
SO ./sprites/gray-bricks.xpm
WE ./sprites/light-blue-bricks.xpm
EA ./sprites/orange-bricks.xpm

F 0,154,23
C 173,216,230

1111111111111111111111111
1000000000110000000000001
1011000001110000000000001
11111111100000000000000011111111111111111
		111111111011000011110000000000001
		100000000011000001110111111111111
		11110111111111011100000010001
		11110111111111011101010010001
	   111000000110101011100000000001
	   100000000000000001000000010001
	   10000000000000001101010010000111
		11000001110101011111011110N0001
		11110111 1110101 10111101000111
		11111111 1111111 111111111111